XXXXXXXXXXXXXX
X*XXX XXXXXXXX
X            X
X XX XXXXX X X
XXXX       X@X
X@    XXXXXXXX
XXXXXXXXXXXXXX